{
    "levels": [
        {
            "level": 1,
            "rows": 5,
            "columns": 8,
            "layout": [
                [1, 1, 1, 1, 1, 1, 1, 1],
                [0, 2, 2, 0, 0, 2, 2, 0],
                [1, 1, 1, 1, 1, 1, 1, 1],
                [0, 1, 0, 1, 1, 0, 1, 0],
                [3, 3, 3, 3, 3, 3, 3, 3]
            ]
        },
        {
            "level": 2,
            "rows": 6,
            "columns": 8,
            "layout": [
                [1, 1, 2, 2, 2, 2, 1, 1],
                [2, 0, 3, 0, 0, 3, 0, 2],
                [2, 3, 1, 1, 1, 1, 3, 2],
                [1, 0, 1, 0, 0, 1, 0, 1],
                [3, 3, 3, 3, 3, 3, 3, 3],
                [0, 1, 1, 1, 1, 1, 1, 0]
            ]
        },
        {
            "level": 3,
            "rows": 7,
            "columns": 8,
            "layout": [
                [1, 2, 2, 3, 3, 3, 2, 1],
                [1, 0, 0, 4, 4, 4, 0, 1],
                [3, 3, 2, 2, 1, 2, 3, 3],
                [0, 1, 0, 3, 3, 3, 0, 1],
                [1, 1, 1, 3, 3, 3, 1, 1],
                [4, 4, 4, 2, 2, 2, 4, 4],
                [0, 1, 1, 0, 0, 1, 1, 0]
            ]
        },
        {
            "level": 4,
            "rows": 8,
            "columns": 8,
            "layout": [
                [3, 3, 2, 2, 1, 1, 2, 2],
                [2, 0, 1, 0, 0, 0, 1, 0],
                [3, 4, 4, 3, 3, 3, 4, 4],
                [1, 1, 2, 2, 2, 2, 2, 1],
                [4, 4, 3, 3, 1, 1, 3, 4],
                [2, 1, 2, 1, 1, 1, 2, 2],
                [0, 3, 3, 4, 4, 4, 3, 0],
                [3, 3, 3, 2, 2, 2, 3, 3]
            ]
        },
        {
            "level": 5,
            "rows": 8,
            "columns": 8,
            "layout": [
                [3, 3, 3, 3, 3, 3, 3, 3],
                [3, 2, 2, 1, 1, 2, 2, 3],
                [2, 1, 0, 4, 4, 0, 1, 2],
                [3, 3, 4, 1, 1, 4, 3, 3],
                [3, 2, 2, 2, 2, 2, 2, 3],
                [2, 1, 3, 3, 3, 3, 1, 2],
                [3, 3, 3, 3, 3, 3, 3, 3],
                [1, 1, 1, 1, 1, 1, 1, 1]
            ]
        },
        {
            "level": 6,
            "rows": 8,
            "columns": 8,
            "layout": [
                [4, 4, 4, 4, 4, 4, 4, 4],
                [3, 3, 2, 2, 2, 2, 3, 3],
                [2, 1, 0, 1, 1, 0, 1, 2],
                [4, 4, 4, 1, 1, 4, 4, 4],
                [1, 2, 2, 2, 2, 2, 2, 1],
                [4, 1, 3, 3, 3, 3, 1, 4],
                [2, 2, 1, 1, 1, 1, 2, 2],
                [3, 3, 3, 3, 3, 3, 3, 3]
            ]
        },
        {
            "level": 7,
            "rows": 8,
            "columns": 8,
            "layout": [
                [1, 1, 1, 1, 1, 1, 1, 1],
                [3, 3, 3, 2, 2, 3, 3, 3],
                [4, 4, 4, 0, 0, 4, 4, 4],
                [1, 1, 1, 3, 3, 1, 1, 1],
                [2, 2, 3, 3, 3, 3, 2, 2],
                [3, 0, 0, 3, 3, 0, 0, 3],
                [4, 4, 2, 2, 2, 2, 4, 4],
                [3, 3, 3, 3, 3, 3, 3, 3]
            ]
        },
        {
            "level": 8,
            "rows": 8,
            "columns": 8,
            "layout": [
                [1, 1, 1, 1, 1, 1, 1, 1],
                [2, 2, 2, 0, 0, 2, 2, 2],
                [4, 4, 4, 3, 3, 4, 4, 4],
                [1, 1, 1, 3, 3, 1, 1, 1],
                [3, 3, 3, 3, 3, 3, 3, 3],
                [4, 2, 2, 1, 1, 2, 2, 4],
                [3, 4, 4, 3, 3, 4, 4, 3],
                [1, 1, 1, 1, 1, 1, 1, 1]
            ]
        },
        {
            "level": 9,
            "rows": 8,
            "columns": 8,
            "layout": [
                [3, 3, 3, 3, 3, 3, 3, 3],
                [1, 2, 4, 4, 4, 4, 2, 1],
                [3, 1, 0, 2, 2, 0, 1, 3],
                [4, 3, 4, 1, 1, 4, 3, 4],
                [2, 2, 1, 3, 3, 1, 2, 2],
                [1, 3, 3, 4, 4, 3, 3, 1],
                [4, 4, 2, 2, 2, 2, 4, 4],
                [1, 1, 1, 1, 1, 1, 1, 1]
            ]
        }
    ]
}